0000000000000000000000000000
0222222222222002222222222220
0200002000002002000002000020
0301102011102002011102011030
0200002000002002000002000020
0222222222222222222222222220
0200002002000000002002000020
0200002002000000002002000020
0222222002222002222002222220
0000002000001001000002000000
1111102000001001000002011111
1111102001111111111002011111
1111102001000110001002011111
0000002001011111101002000000
0222222111011111101112222220
0000002001011111101002000000
1111102001000000001002011111
1111102001111111111002011111
1111102001000000001002011111
0000002001000000001002000000
0222222222222002222222222220
0200002000002002000002000020
0200002000002002000002000020
0322002222222222222222002230
0002002002000000002002002000
0002002002000000002002002000
0222222002222002222002222220
0200000000002002000000000020
0200000000002002000000000020
0222222222222222222222222220
0000000000000000000000000000