00000000000000000000000
02222222222022222222220
02000200002020000200020
03000200002020000200030
02000200002020000200020
02222222222222222222220
02000202000000020200020
02222202222022220222220
00000200002020000200000
11110202222222220201111
11110202000500020201111
00000202011111020200000
22222222011111022222222
00000202011111020200000
11110202000000020201111
11110202222122220201111
00000202000000020200000
02222222222022222222220
02000200002020000200020
03220222222222222202230
00020202000000020202000
02222202222022220222220
02000000002020000000020
02222222222222222222220
00000000000000000000000
11 15