00000000
10101010
11111111
01010101
02030200
04020200
02020200
02222200
00000000