00000000000000000000
01001001000010010010
00000000000000000000
00000000000000000000
01001000000000010010
00000000000000000000
00000000000000000000
01001001000010010010
00000000000000000000
00000000000000000000
01001000000000010010
00000000000000000000
00000000000000000000
01001001000010010010
00000000000000000000
00000000000000000000
01001001000010010010
00000000000000000000
00000000000000000000
00000000000000000000
