000000000000000
011212111212120
010010000020010
010010000020020
021222222222210
000200050002000
000201111102000
010201111102120
020201111102020
020200000002020
020211111112010
020000010010020
020010010010020
022221222211220
000000000000000
7 10