000000000000000
012211221211120
010000010010010
020000010000020
010222222222120
020200050002000
020201111102000
011201111102220
000201111102010
000200000002010
022211111112110
020000020010010
020000020010020
011221111121120
000000000000000
7 10