000000000000000
012112220011210
020010020020020
020010020020010
012222222222020
020200050002020
010201111102010
022201111102110
000201111102000
000200000002000
021211111112210
020010010000010
020020010000010
022110022111110
000000000000000
7 10