000000000000000
011112121111220
010020020000020
020020010000020
021222222222110
020200050002020
020201111102020
022201111102220
000201111102010
000200000002010
011211111112020
020010020000010
020010020000010
021220021222210
000000000000000
7 10