000000000000000
021210021121220
010010020020010
010000020020020
012222222222110
010200050002000
010201111102000
010201111102010
020201111102020
020200000002010
020211111112010
010010000020020
020010000020020
021211211222110
000000000000000
7 10