000000000000000
021211210012110
010020020020020
010010010010010
011222222222210
010200050002010
010201111102010
021201111102120
000201111102000
000200000002000
012211111112110
020000010000020
020000020000020
011221122221210
000000000000000
7 10