000000000000000
022111110012110
020010020010020
020000010010010
022222222222020
010200050002010
020201111102010
011201111102010
000201111102010
000200000002020
012211111112120
020000000010020
020000010010020
022121120012210
000000000000000
7 10