000000000000000
012222110012220
010010020010010
020000020000010
012222222222210
010200050002020
020201111102020
020201111102010
020201111102020
020200000002020
021211111112120
010020010010020
010020020020010
011222111212120
000000000000000
7 10