000000000000000
011120012122120
010020020000020
010020020000010
021222222222220
010200050002020
020201111102010
021201111102220
000201111102000
000200000002000
021211111112210
020000010000010
020000010000020
021122211112220
000000000000000
7 10