000000000000000
012121122212220
010000010010010
010000000010010
022222222222110
020200050002000
010201111102000
010201111102120
000201111102020
000200000002010
012211111112120
010020010000010
020020020000010
022210011221220
000000000000000
7 10