000000000000000
022212122121120
010000010020010
010000010010020
020222222222120
020200050002020
010201111102020
022201111102010
010201111102020
020200000002020
011211111112010
010000020020020
010000020020020
011111120022210
000000000000000
7 10