000000000000000
012220022222210
010020010010020
020010000010010
011222222222010
010200050002020
020201111102020
021201111102010
020201111102010
010200000002010
012211111112010
010000000000010
010000000010010
011111112112120
000000000000000
7 10