000000000000000
012112112112210
020010000000010
010010000000020
022222222222220
010200050002010
020201111102010
021201111102010
020201111102020
020200000002010
011211111112220
020000020000020
010000020010010
011222110011210
000000000000000
7 10