000000000000000
011110011111110
010010010000010
010010010000010
011222222222110
000200050002010
000201111102010
011201111102110
010201111102010
010200000002010
010211111112110
010010010010020
010010010010020
011111110012220
000000000000000
7 10