000000000000000
011111111112220
010010000010010
010010000010010
011222222222010
000200050002010
000201111102010
011201111102110
010201111102010
010200000002010
011211111112010
010010010010010
010010010010010
011111110011110
000000000000000
7 10