000000000000000
011111111111110
010010000010010
010010000010010
011222222222010
010200050002010
010201111102010
010201111102010
010201111102010
010200000002010
011211111112010
020010000010010
020010000010010
021111111111110
000000000000000
7 10