000000000000000
011220012122110
010020020000010
020010020000010
010222222222120
020200050002020
010201111102010
010201111102020
000201111102010
000200000002010
012211111112220
020020010000010
020020020000020
012220012111220
000000000000000
7 10