000000000000000
012110012221210
010020020010010
010020020010010
011222222222010
020200050002010
020201111102010
021201111102010
020201111102020
010200000002020
021211111112120
020010010010020
010020020020010
021221221111110
000000000000000
7 10