000000000000000
021110022222110
010020020020020
010020010010010
020222222222210
010200050002020
010201111102010
010201111102010
010201111102000
020200000002000
010211111112220
010020000000020
020020000000020
011111222222220
000000000000000
7 10