000000000000000
021112221212210
020000000010020
020000000010020
022222222222120
020200050002020
020201111102010
010201111102220
010201111102010
020200000002020
020211111112220
020010010000020
020020020010010
021120012222110
000000000000000
7 10