000000000000000
012212211111210
010000000000020
020000000000020
012222222222110
010200050002010
010201111102020
021201111102110
020201111102010
010200000002020
022211111112210
010020010000020
010020010010020
021212110021120
000000000000000
7 10