000000000000000
012111121111110
020020020010020
010010020010020
021222222222120
020200050002020
010201111102020
021201111102120
000201111102020
000200000002010
021211111112120
020020020000010
010020020000010
021122222111120
000000000000000
7 10