000000000000000
012210021212210
020020020000010
020020010000020
021222222222110
010200050002020
020201111102010
010201111102010
020201111102010
010200000002010
010211111112210
010000000020010
010000000020010
011211211111210
000000000000000
7 10