000000000000000
021111110011110
010010010010010
010010010010010
011222222222110
010200050002010
010201111102010
011201111102110
010201111102010
010200000002010
011211111112010
010010010010010
010010010010010
011111110011110
000000000000000
7 10