000000000000000
011110011212220
020020010020010
020020010020020
022222222222020
020200050002010
010201111102020
010201111102010
020201111102020
020200000002010
021211111112120
020000010000010
010010010000020
011122111221220
000000000000000
7 10