000000000000000
022122120022210
020000020020010
020000010010020
010222222222120
020200050002020
020201111102010
010201111102110
020201111102020
010200000002010
020211111112210
020000000000010
010010010000020
012110011121220
000000000000000
7 10