000000000000000
011111111112220
010010000010010
010010000010010
011222222222110
010200050002010
010201111102010
010201111102110
010201111102010
010200000002010
010211111112010
010010010010010
010010010010010
011110011111110
000000000000000
7 10