000000000000000
012122212222110
020000000000020
020000000000010
021222222222210
020200050002000
010201111102000
011201111102110
000201111102020
000200000002020
011211111112020
010000000010020
020000010020010
021222111212120
000000000000000
7 10