000000000000000
022222222222220
020020000020020
020020000020020
022222222222220
020200050002020
020201111102020
020201111102220
020201111102020
020200000002020
022211111112220
020000000020020
020000000020020
022222222222220
000000000000000
7 10