000000000000000
012112111211210
010000010000020
020000010000020
011222222222220
020200050002010
010201111102010
010201111102010
000201111102010
000200000002020
021211111112110
020000020000020
020010020010020
022222210021120
000000000000000
7 10