000000000000000
012222220011220
020020010020020
020010000010020
011222222222020
000200050002020
000201111102010
010201111102010
020201111102010
010200000002010
012211111112020
010000000010010
020000010020020
012112222122110
000000000000000
7 10