000000000000000
011211210022120
010000020010010
020000020000010
022222222222120
010200050002020
010201111102010
022201111102010
020201111102010
010200000002020
022211111112220
010000020020020
010010020020020
012122111212120
000000000000000
7 10