000000000000000
022110021122120
020010010020020
010000000010020
011222222222210
010200050002010
010201111102010
022201111102010
000201111102020
000200000002020
021211111112110
010000010000010
010000020000020
021222112221210
000000000000000
7 10