000000000000000
021111120022220
010010020010010
020010010010020
021222222222120
000200050002020
000201111102020
011201111102020
010201111102020
010200000002020
010211111112210
010020000020020
010020000020020
021221111111210
000000000000000
7 10