000000000000000
021111111111110
010010010000010
010010010000010
010222222222110
010200050002010
010201111102010
011201111102110
010201111102010
010200000002010
011211111112110
010000000000010
010000000000010
011111111111110
000000000000000
7 10