000000000000000
022111222212220
010010000020010
010010000010020
021222222222110
020200050002020
010201111102010
011201111102020
000201111102010
000200000002010
012211111112020
020000010000020
010000010000010
021112111221120
000000000000000
7 10