000000000000000
011220012221210
020020010010010
010020010010020
020222222222220
010200050002020
020201111102010
021201111102010
010201111102010
020200000002010
010211111112110
010000000020020
020000000020020
021222112212120
000000000000000
7 10