000000000000000
012220012111120
020020020020020
010020020020020
011222222222220
010200050002000
020201111102000
011201111102120
020201111102020
010200000002010
010211111112020
020020000000010
010020010000020
011120022111210
000000000000000
7 10