000000000000000
011110011111110
010010010000010
010010010000010
010222222222010
010200050002010
010201111102010
011201111102010
010201111102010
010200000002010
011211111112110
010000010000020
010000010000020
011111111112220
000000000000000
7 10