000000000000000
011212112212220
020020010010010
010020010000020
021222222222110
000200050002010
000201111102020
010201111102010
020201111102010
010200000002020
011211111112120
020020010010010
010020020010020
012111212222220
000000000000000
7 10