000000000000000
011111111111110
010010010000010
010010010000010
011222222222110
010200050002000
010201111102000
011201111102110
000201111102010
000200000002010
011211111112110
020010010010010
020010010010010
021110011111110
000000000000000
7 10