000000000000000
012112221121120
020020010020020
020010000010020
010222222222010
010200050002010
010201111102010
010201111102010
000201111102000
000200000002000
011211111112120
020010020000020
010010020000020
011120012222120
000000000000000
7 10