000000000000000
012221121222110
010000000020010
010000000010010
012222222222010
010200050002010
010201111102020
011201111102120
000201111102010
000200000002010
012211111112120
010000000010020
020010010020010
012211111111210
000000000000000
7 10