000000000000000
011220012111110
010010020020020
020010020010010
021222222222210
010200050002020
010201111102010
010201111102010
000201111102000
000200000002000
021211111112110
010000000020020
020010010020020
022221220022220
000000000000000
7 10