000000000000000
011110022112120
020010010010020
010000000010020
011222222222010
000200050002010
000201111102010
021201111102020
010201111102010
010200000002020
010211111112120
010010010000010
020020020000020
012212211122110
000000000000000
7 10