000000000000000
011212210022210
010010020020010
020010010020020
020222222222220
020200050002010
010201111102020
011201111102110
010201111102000
010200000002000
022211111112210
020020020000010
010020020000020
012111222111210
000000000000000
7 10