000000000000000
011212120011110
020020010010010
010010000000020
010222222222120
020200050002000
020201111102000
010201111102110
010201111102020
010200000002010
012211111112210
020000000000010
010000000010010
011111121221120
000000000000000
7 10