000000000000000
022220022222220
020020020000020
020020020000020
020222222222220
020200050002000
020201111102000
020201111102220
020201111102020
020200000002020
022211111112220
020020020020020
020020020020020
022222220022220
000000000000000
7 10