000000000000000
022122122222120
020020020020020
010020010010010
011222222222220
010200050002000
020201111102000
010201111102220
020201111102010
020200000002010
022211111112120
010010020020010
010020020020010
021220012111110
000000000000000
7 10