000000000000000
011122210021110
010000010010020
010000010000010
022222222222110
000200050002000
000201111102000
011201111102120
020201111102020
020200000002010
012211111112210
020010000000020
010020000010020
011211212121220
000000000000000
7 10