000000000000000
022220022222210
010010020010020
010010020000010
022222222222210
020200050002000
010201111102000
021201111102010
020201111102020
010200000002020
021211111112010
020000010010010
020000020020020
012112121121120
000000000000000
7 10