000000000000000
012211112111110
010020020000020
010020010000010
010222222222110
010200050002000
020201111102000
021201111102220
020201111102010
020200000002020
011211111112010
020000010000020
020000020000020
011121211211110
000000000000000
7 10