000000000000000
011120011112220
020010010020010
020010010010020
010222222222120
010200050002010
020201111102020
010201111102020
000201111102020
000200000002010
011211111112020
020000010000020
020000020000020
021212111111210
000000000000000
7 10