000000000000000
012210022121210
010020020010020
010010010010010
010222222222110
010200050002010
010201111102020
020201111102220
020201111102000
020200000002000
021211111112110
010020010020020
020020020020020
012221121112120
000000000000000
7 10