000000000000000
012122120021210
020010010010010
020010010010010
021222222222120
010200050002000
010201111102000
022201111102220
010201111102010
010200000002020
011211111112110
020020020010020
010020020010020
012120022121210
000000000000000
7 10