000000000000000
012110012121110
010020010010020
010010010000010
010222222222010
020200050002010
010201111102020
021201111102010
000201111102020
000200000002010
022211111112010
010000000010010
020010010020020
021112220012110
000000000000000
7 10