000000000000000
011111212211120
010010000010020
010000000010020
022222222222210
000200050002010
000201111102010
010201111102010
010201111102020
020200000002010
011211111112220
020000010010010
020000010010010
022121110011210
000000000000000
7 10