000000000000000
021121121121110
010000020020020
010000020020010
012222222222020
020200050002020
020201111102010
011201111102020
010201111102010
020200000002020
010211111112120
010000020000010
020010020000020
022112111122220
000000000000000
7 10