000000000000000
011111111111110
010000010010010
010000010010010
011222222222110
010200050002010
010201111102010
011201111102010
010201111102010
010200000002010
011211111112110
010010000010020
010010000010020
011111111112220
000000000000000
7 10