000000000000000
011110022122120
010020020010020
020010020000020
011222222222210
000200050002010
000201111102010
021201111102010
010201111102010
020200000002010
020211111112120
020000020010020
010000020020020
011221222211120
000000000000000
7 10