000000000000000
011111111111110
010010000010010
010010000010010
011222222222010
000200050002010
000201111102010
011201111102110
010201111102000
010200000002000
011211111112110
010010010010020
010010010010020
011110011112220
000000000000000
7 10