000000000000000
021210012221220
020010010000020
020000010000020
012222222222020
000200050002010
000201111102010
022201111102010
020201111102020
010200000002020
011211111112210
020000000000010
020000010010020
021122110012120
000000000000000
7 10