000000000000000
021222112222220
020010010000010
010000000000020
021222222222120
010200050002020
020201111102010
010201111102010
020201111102020
020200000002020
010211111112010
020010010010010
020020010010020
011121212211120
000000000000000
7 10