000000000000000
011122222111110
020010020010010
020010010000010
022222222222120
000200050002020
000201111102010
010201111102010
010201111102010
010200000002020
020211111112120
010010000010010
010010010010020
021110021222120
000000000000000
7 10