000000000000000
021111212212220
010000000000010
010000000000010
011222222222210
010200050002010
020201111102010
010201111102120
010201111102020
010200000002010
010211111112220
020000000010020
020010010020010
021210011221110
000000000000000
7 10