000000000000000
012111110011110
010020020010010
010010010000010
022222222222110
000200050002010
000201111102010
011201111102010
010201111102020
010200000002010
020211111112210
010020020000010
010020020000010
012121121112120
000000000000000
7 10