000000000000000
011111111112220
010010010000010
010010010000010
011222222222110
000200050002010
000201111102010
011201111102110
010201111102000
010200000002000
010211111112110
010010010010010
010010010010010
011111111111110
000000000000000
7 10