000000000000000
022121122211220
020020000010010
010010000010010
011222222222220
010200050002020
010201111102010
011201111102120
000201111102010
000200000002020
012211111112210
010020010000010
020020020010010
012211212121110
000000000000000
7 10