000000000000000
021210022222220
020010020020020
010000010020020
021222222222210
010200050002010
020201111102010
010201111102120
010201111102000
010200000002000
011211111112210
020010000010010
020020000020020
022111122221110
000000000000000
7 10