000000000000000
022222222222220
020000020000020
020000020000020
022222222222220
020200050002020
020201111102020
022201111102220
020201111102020
020200000002020
020211111112020
020000020020020
020000020020020
022222222222220
000000000000000
7 10