000000000000000
021111211211220
010010020000020
010000020000020
021222222222110
010200050002010
020201111102020
021201111102020
000201111102020
000200000002020
021211111112010
010000000020020
010000000020020
021121221222110
000000000000000
7 10