000000000000000
021111110011110
010000010010010
010000010010010
010222222222110
010200050002010
010201111102010
011201111102110
000201111102000
000200000002000
011211111112110
010010010010010
010010010010010
011110011111110
000000000000000
7 10