000000000000000
011111110012220
010010010010010
010010010010010
011222222222110
010200050002000
010201111102000
011201111102110
000201111102010
000200000002010
011211111112010
010000010000010
010000010000010
011111111111110
000000000000000
7 10