000000000000000
021122212111120
010000000010010
020000000010020
020222222222220
010200050002020
010201111102010
020201111102220
020201111102020
010200000002010
011211111112020
020010010020020
010020020020010
021211212211110
000000000000000
7 10