000000000000000
011111111112220
010010010010010
010010010010010
010222222222010
010200050002010
010201111102010
011201111102010
010201111102010
010200000002010
011211111112110
010000010000010
010000010000010
011111111111110
000000000000000
7 10