000000000000000
021212112221110
010010000020020
020010000020020
011222222222110
020200050002020
020201111102010
010201111102110
010201111102010
010200000002020
020211111112120
020000000000020
010010000000010
012111221121120
000000000000000
7 10