000000000000000
011111111112220
010010000010010
010010000010010
010222222222110
010200050002010
010201111102010
010201111102010
010201111102010
010200000002010
011211111112010
010000010010010
010000010010010
011111110011110
000000000000000
7 10