000000000000000
011211120021220
010020010020010
010010010010010
012222222222120
010200050002000
010201111102000
021201111102220
010201111102010
020200000002010
021211111112010
020000010000010
010010010000010
022122122111110
000000000000000
7 10