000000000000000
011111110011110
010010010010010
010010010010010
011222222222110
010200050002000
010201111102000
011201111102110
010201111102010
010200000002010
011211111112010
020000010010010
020000010010010
021111111111110
000000000000000
7 10