000000000000000
022222220022220
020020020020020
020020020020020
022222222222220
020200050002000
020201111102000
020201111102220
020201111102020
020200000002020
022222222222220
020020000000020
020020000000020
022222222222220
000000000000000
7 10