000000000000000
012212211111120
020020020000010
020010010000020
011222222222210
020200050002020
010201111102010
010201111102120
010201111102010
020200000002020
021211111112110
020000020010010
010000020010020
022121120021210
000000000000000
7 10