000000000000000
021111110011110
010010010010010
010010010010010
011222222222110
010200050002000
010201111102000
011201111102110
010201111102010
010200000002010
010211111112110
010000000010010
010000000010010
011111111111110
000000000000000
7 10