000000000000000
012121210022220
020000010010020
020000000010010
011222222222110
020200050002010
010201111102010
010201111102010
020201111102010
020200000002010
020211111112220
010000010010020
020010020010020
011120011221120
000000000000000
7 10