000000000000000
012112211111120
010000020020010
020000010020020
021222222222210
000200050002000
000201111102000
011201111102120
010201111102010
020200000002010
020211111112010
020000000000010
010010000000010
011211222211210
000000000000000
7 10