000000000000000
012221212121220
020010000010020
020000000000020
012222222222210
020200050002000
010201111102000
010201111102120
020201111102020
020200000002020
021211111112110
010010000010010
010010010020020
021222121121210
000000000000000
7 10