000000000000000
022210021121110
010010010010020
010000000000010
020222222222210
010200050002010
020201111102020
010201111102110
010201111102020
020200000002020
012211111112210
020000010010020
010000010010010
021111212111110
000000000000000
7 10