000000000000000
022112120022220
020000020010020
010000020000020
020222222222110
010200050002020
010201111102020
011201111102020
010201111102010
010200000002020
022211111112210
010020020000010
010020020010010
011111120022110
000000000000000
7 10