000000000000000
011112121122120
010020020020010
010010010020020
022222222222210
020200050002020
010201111102020
011201111102220
020201111102010
020200000002010
021211111112020
010020000010020
010020010010010
022122121222210
000000000000000
7 10