000000000000000
022121221121120
020020020000020
020010020000020
012222222222220
010200050002020
020201111102010
010201111102120
010201111102010
020200000002020
021211111112020
020010010010020
010010010020020
011111221122220
000000000000000
7 10