000000000000000
022122222222220
010010000010010
010010000000020
022222222222110
010200050002020
020201111102020
011201111102010
020201111102010
010200000002010
010211111112110
020010000000020
020010010000010
021110012221210
000000000000000
7 10