000000000000000
011111121211220
020010020020010
020010020010010
021222222222020
020200050002020
010201111102020
010201111102120
020201111102000
010200000002000
012211111112120
010010020000020
010020020010010
022121221222110
000000000000000
7 10