000000000000000
022112112121120
010000010020020
010000000020020
011222222222210
010200050002020
010201111102020
022201111102120
000201111102000
000200000002000
022211111112120
020020000010010
010020000020010
011222211211110
000000000000000
7 10