000000000000000
021220011111120
010020020000010
010010020000010
012222222222210
000200050002000
000201111102000
022201111102010
020201111102010
020200000002010
012211111112210
010020010010020
010020010010020
021211110021110
000000000000000
7 10