000000000000000
012120022222110
010010020010020
020010020000020
011222222222110
000200050002010
000201111102020
021201111102020
020201111102020
020200000002020
012211111112020
020010010010020
020010010020010
021212222212210
000000000000000
7 10