000000000000000
011211212221120
020020010020010
020020010020010
021222222222020
010200050002010
010201111102010
011201111102120
020201111102020
020200000002020
012211111112020
010010000020010
010020000020020
012212221221220
000000000000000
7 10