000000000000000
021121211222220
020010010020020
020010010010010
021222222222120
000200050002010
000201111102010
021201111102120
010201111102010
010200000002010
011211111112020
010020010010020
020020020010020
011211120021120
000000000000000
7 10