000000000000000
022222220011120
010010010020020
020010000020020
021222222222210
020200050002020
020201111102010
020201111102010
020201111102000
020200000002000
010211111112110
020010010000020
020020020000020
021220011222120
000000000000000
7 10