000000000000000
022112212222110
010000000010010
010000000000010
021222222222010
000200050002020
000201111102020
011201111102010
010201111102020
010200000002020
021211111112120
010010000000010
020010010010010
021211212112110
000000000000000
7 10