000000000000000
022112122212110
020020020000020
020020010000010
022222222222010
020200050002020
020201111102010
022201111102220
020201111102020
010200000002020
010211111112010
020020020010020
020020020010010
021212110012110
000000000000000
7 10