000000000000000
012221122112210
020000000000010
010000000000010
012222222222220
020200050002020
020201111102010
010201111102220
020201111102010
020200000002020
011211111112110
010020000010010
020020010020010
022122211221120
000000000000000
7 10