000000000000000
011110011112220
010010010010010
010010010010010
010222222222010
010200050002010
010201111102010
011201111102010
010201111102010
010200000002010
010211111112110
010010000000010
010010000000010
011111111111110
000000000000000
7 10