000000000000000
012122212222220
010000010020010
010000010010020
022222222222110
010200050002000
020201111102000
022201111102120
010201111102020
010200000002020
021211111112010
010010020020020
020020020020020
011210022221210
000000000000000
7 10