000000000000000
011111111111110
010010010010010
010010010010010
011222222222010
010200050002010
010201111102010
011201111102110
010201111102010
010200000002010
010211111112110
010010010010020
010010010010020
011110011112220
000000000000000
7 10