000000000000000
011212120021220
020010020010020
020000020010010
020222222222010
020200050002020
010201111102010
011201111102010
000201111102000
000200000002000
021211111112110
020020010020020
010020010020020
021211221212120
000000000000000
7 10