000000000000000
011112112221210
020010000020010
020000000010020
011222222222110
010200050002020
010201111102010
010201111102110
020201111102010
020200000002020
020211111112120
020020000000020
020020010000020
021120011112110
000000000000000
7 10