000000000000000
021120022112210
020010020020010
020000020020010
010222222222220
010200050002020
020201111102020
011201111102120
010201111102000
020200000002000
011211111112210
020000010000010
010000010010010
022222210022120
000000000000000
7 10