000000000000000
022111121222220
020000000000020
010000000000010
012222222222210
020200050002010
020201111102010
011201111102110
000201111102010
000200000002020
022211111112120
010000000000010
010000000000010
021111212221220
000000000000000
7 10