000000000000000
011110011111110
010010010000010
010010010000010
011222222222010
010200050002010
010201111102010
010201111102110
010201111102000
010200000002000
011211111112110
010000000010020
010000000010020
011111111112220
000000000000000
7 10