000000000000000
011212221121120
010010020020010
010010020010010
012222222222210
000200050002010
000201111102010
010201111102020
010201111102010
010200000002010
022211111112020
010010010010010
010010010010020
012110012111220
000000000000000
7 10