000000000000000
012212112222210
010000010000010
010000000000010
011222222222210
000200050002000
000201111102000
011201111102220
010201111102020
020200000002010
012211111112010
010000000000010
010000000010010
011221111212220
000000000000000
7 10