000000000000000
011111111111110
010000010010010
010000010010010
011222222222010
000200050002010
000201111102010
011201111102110
010201111102010
010200000002010
011211111112110
010000010000020
010000010000020
011111111112220
000000000000000
7 10