000000000000000
012112222211220
020020000000020
020020000000020
021222222222010
000200050002020
000201111102020
010201111102110
010201111102000
010200000002000
020211111112120
020000000010010
020010010020020
012210011122210
000000000000000
7 10