000000000000000
011221220012210
010020010010010
010010000010020
012222222222220
010200050002010
010201111102010
020201111102020
020201111102020
020200000002010
022211111112120
020020000000020
010020010000010
022122222212120
000000000000000
7 10