000000000000000
012120011222120
010010020010010
010010010010010
020222222222110
020200050002010
020201111102020
020201111102220
010201111102010
020200000002010
011211111112220
010000000000010
020010010010010
011120012121120
000000000000000
7 10