000000000000000
022222220022220
020000020020020
020000020020020
022222222222020
000200050002020
000201111102020
022201111102220
020201111102000
020200000002000
020211111112220
020020000000020
020020000000020
022222222222220
000000000000000
7 10