000000000000000
022211122221210
020020020010010
010010010000010
020222222222210
010200050002010
020201111102020
021201111102120
020201111102000
010200000002000
020211111112210
010020000010010
020020010010020
011221120011220
000000000000000
7 10