000000000000000
022222222222220
020000000000020
020000000000020
022222222222220
020200050002000
020201111102000
022201111102220
000201111102020
000200000002020
022211111112220
020020020020020
020020020020020
022222220022220
000000000000000
7 10