000000000000000
021211111111110
020000010020010
010000010010020
020222222222120
020200050002020
010201111102010
020201111102220
010201111102020
020200000002020
012211111112010
010000010010020
020000020010010
022112121212210
000000000000000
7 10