000000000000000
021210022212120
010020020020010
010020020010010
010222222222210
020200050002000
010201111102000
022201111102110
020201111102010
010200000002020
020211111112010
020000010000020
020000010000020
012222212212110
000000000000000
7 10