000000000000000
021111111111110
010010000010010
010010000010010
011222222222110
000200050002000
000201111102000
011201111102110
010201111102010
010200000002010
011211111112110
010000000010010
010000000010010
011111111111110
000000000000000
7 10