000000000000000
011222222211120
010000000000020
010000000000020
021222222222220
000200050002020
000201111102020
021201111102010
020201111102020
020200000002010
021211111112210
010020010010010
010020020020010
021220021221110
000000000000000
7 10