000000000000000
021110011111110
010010010000010
010010010000010
011222222222110
010200050002010
010201111102010
011201111102110
000201111102000
000200000002000
011211111112110
010000010010010
010000010010010
011111111111110
000000000000000
7 10