000000000000000
022212212122110
020000020000010
020000010000010
011222222222110
010200050002020
010201111102020
020201111102010
020201111102010
010200000002020
021211111112120
010000000010010
010000000010020
011221121212110
000000000000000
7 10