000000000000000
021121220022210
020000010010020
010000010010010
022222222222120
020200050002010
010201111102010
010201111102010
010201111102010
010200000002010
011211111112220
020000000010020
020000000020010
011222111122210
000000000000000
7 10