000000000000000
022220021212110
020010020010010
020010020000010
021222222222120
020200050002020
020201111102010
022201111102010
010201111102020
020200000002010
011211111112110
020010000010020
020020000020020
012212222221210
000000000000000
7 10