000000000000000
021110012221220
010010010020010
020010010010020
021222222222210
010200050002020
020201111102010
010201111102020
020201111102010
020200000002020
022211111112120
010020010000010
010020010000010
021120012111210
000000000000000
7 10