000000000000000
011211211212120
020000020020010
010000010020010
021222222222010
010200050002020
020201111102020
010201111102010
000201111102020
000200000002010
022211111112220
020000010020010
010000010020020
011212110011210
000000000000000
7 10