000000000000000
011212210011110
020000010020020
020000010010010
011222222222220
000200050002000
000201111102000
021201111102110
010201111102020
020200000002010
021211111112210
020010010010020
010010010010020
022212212211220
000000000000000
7 10