000000000000000
021221212211120
020020000000010
020010000000020
011222222222220
000200050002000
000201111102000
011201111102120
010201111102020
020200000002020
022211111112110
010010010000020
010020020010020
011212210021120
000000000000000
7 10