000000000000000
021211221112220
010010010020010
020000010020010
022222222222010
020200050002020
020201111102020
021201111102010
020201111102010
010200000002020
010211111112120
020000000000010
010000000010010
012211122121110
000000000000000
7 10