000000000000000
022120011112120
020010020020010
020000020010010
011222222222120
010200050002020
020201111102020
022201111102120
010201111102000
020200000002000
021211111112210
020000000010020
020000000010020
022112111121210
000000000000000
7 10