000000000000000
021210022221120
020010010020020
020010010020020
011222222222110
010200050002020
020201111102020
022201111102110
000201111102000
000200000002000
012211111112220
010010000020010
010010010020020
011110022111110
000000000000000
7 10