000000000000000
012220021121210
020020020020020
010010010010010
012222222222110
020200050002010
020201111102010
010201111102110
020201111102000
020200000002000
010211111112120
010000000000020
010000000000020
021112212211120
000000000000000
7 10