000000000000000
012221112222110
010020010000020
020010000000010
011222222222120
020200050002020
020201111102010
010201111102010
010201111102020
020200000002020
020211111112220
020020000020010
010020000020020
021212211111220
000000000000000
7 10