000000000000000
022122210022220
010020010010010
010020010000010
010222222222110
010200050002000
010201111102000
010201111102120
000201111102010
000200000002020
021211111112210
020010010020020
020010010020010
011121220012220
000000000000000
7 10