000000000000000
021122212112210
010000000000010
010000000000020
022222222222220
010200050002000
020201111102000
020201111102220
010201111102010
020200000002010
022211111112010
010000010010010
020000010020010
021211210012210
000000000000000
7 10