000000000000000
012221222211220
020000000010020
020000000010020
011222222222020
020200050002010
010201111102010
011201111102220
000201111102020
000200000002010
022211111112220
020000020020020
020000020020020
012211111222110
000000000000000
7 10