000000000000000
011111111111110
010000000010010
010000000010010
011222222222110
010200050002010
010201111102010
011201111102010
010201111102010
010200000002010
010211111112010
020000010010010
020000010010010
021111110011110
000000000000000
7 10