000000000000000
022212112211210
010000010010010
010000010010020
011222222222220
020200050002000
010201111102000
010201111102010
000201111102020
000200000002020
012211111112110
020010020010010
010020020010020
011212221222110
000000000000000
7 10