000000000000000
021120012221210
020010020020020
020000010020020
010222222222220
010200050002010
020201111102020
022201111102010
000201111102020
000200000002020
011211111112020
020000010010010
010000020010010
021221211111210
000000000000000
7 10