000000000000000
012210022222110
020020010020020
010010010010020
020222222222220
010200050002000
010201111102000
010201111102120
000201111102010
000200000002010
021211111112020
010000000000010
020000000000010
011121211121120
000000000000000
7 10