000000000000000
021212211112110
010000020020010
020000010020020
011222222222020
010200050002020
010201111102020
010201111102120
010201111102000
010200000002000
020211111112110
010010000010010
010020010020010
011121110022210
000000000000000
7 10