000000000000000
012210021222110
010020010010020
010010000000010
021222222222010
020200050002010
020201111102020
010201111102110
020201111102020
010200000002020
012211111112220
010000000010010
020000000020020
011112211111210
000000000000000
7 10