000000000000000
012112210022120
010010020020020
010000010010020
012222222222110
000200050002010
000201111102020
011201111102120
010201111102020
010200000002020
011211111112010
010020020000010
010020020010020
022212110021220
000000000000000
7 10