000000000000000
012212221112210
010020020020020
010020020020020
010222222222020
010200050002010
010201111102010
022201111102110
000201111102010
000200000002020
011211111112210
010000010000020
010000020010010
022211112211220
000000000000000
7 10