000000000000000
011110011112220
010010010010010
010010010010010
010222222222010
010200050002010
010201111102010
011201111102110
000201111102010
000200000002010
011211111112110
010010010010010
010010010010010
011111111111110
000000000000000
7 10