000000000000000
012222210012210
010000020010010
020000020010020
011222222222120
020200050002010
020201111102010
022201111102010
010201111102020
020200000002020
021211111112110
010000010010010
010000020020010
012211112112220
000000000000000
7 10