000000000000000
022222220022220
020020020020020
020020020020020
020222222222020
020200050002020
020201111102020
020201111102020
020201111102020
020200000002020
022211111112220
020000000000020
020000000000020
022222222222220
000000000000000
7 10