000000000000000
011111111112220
010010010000010
010010010000010
010222222222110
010200050002010
010201111102010
011201111102110
010201111102010
010200000002010
011211111112110
010010010010010
010010010010010
011110011111110
000000000000000
7 10