000000000000000
022122120011220
010000020020010
010000020010010
022222222222220
010200050002010
020201111102010
011201111102010
000201111102010
000200000002020
011211111112210
010000000010020
010010000010010
021122212112120
000000000000000
7 10