000000000000000
022122220012220
020010010020010
010000000020010
012222222222210
000200050002010
000201111102010
021201111102010
010201111102020
020200000002010
011211111112010
010000010010010
010010020010010
022110012212120
000000000000000
7 10