000000000000000
021222121112210
020020010020010
020020000010020
010222222222010
010200050002010
010201111102020
010201111102020
020201111102020
020200000002020
022211111112110
010000000000020
010010010010020
011111221122110
000000000000000
7 10