000000000000000
022122122112210
010010020000010
020000010000020
021222222222120
020200050002000
010201111102000
011201111102110
000201111102010
000200000002010
012211111112220
010010010010020
010020020020020
011220012121120
000000000000000
7 10