000000000000000
012122111212220
020020010020010
020010010020010
012222222222210
010200050002000
020201111102000
010201111102220
010201111102010
010200000002020
020211111112210
020000010010010
020000010020010
011112221212220
000000000000000
7 10