000000000000000
022221111112110
010020010000010
010020010000020
010222222222110
010200050002020
020201111102010
021201111102020
020201111102020
010200000002010
010211111112120
020000020000010
010000020000010
011122122222220
000000000000000
7 10