000000000000000
012212112112220
010000010020010
020000000010010
011222222222110
020200050002020
010201111102020
021201111102020
010201111102010
020200000002020
021211111112010
020000000010020
010000010010020
012211220022120
000000000000000
7 10