000000000000000
011110011112220
010010010000010
010010010000010
011222222222110
010200050002010
010201111102010
010201111102010
010201111102010
010200000002010
010211111112110
010010010010010
010010010010010
011111110011110
000000000000000
7 10