000000000000000
011110011111110
010010010000010
010010010000010
011222222222010
000200050002010
000201111102010
011201111102110
010201111102000
010200000002000
010211111112110
010010010000020
010010010000020
011110011112220
000000000000000
7 10