000000000000000
021212122121210
010010020000010
010000020000010
012222222222220
010200050002010
020201111102010
020201111102220
020201111102010
020200000002020
011211111112110
010000010000020
010000020010020
012111122122210
000000000000000
7 10