000000000000000
012120011221110
010010020000020
020010020000010
022222222222110
020200050002000
010201111102000
020201111102010
020201111102020
020200000002020
022211111112010
010010010010010
020020010010020
021121111212220
000000000000000
7 10