000000000000000
011111110011110
010010010010010
010010010010010
010222222222010
010200050002010
010201111102010
011201111102110
010201111102010
010200000002010
011211111112010
010010000000020
010010000000020
011111111112220
000000000000000
7 10