000000000000000
022221211111220
020000010000010
020000010000010
012222222222210
000200050002010
000201111102010
022201111102220
010201111102020
010200000002010
010211111112010
010000010000020
010000010000010
022211111221110
000000000000000
7 10