000000000000000
021210021221120
020010020010020
020010020000020
010222222222220
020200050002010
010201111102020
010201111102010
020201111102010
010200000002010
010211111112110
020010010010010
020020010010010
021221221112220
000000000000000
7 10