000000000000000
021110021121110
010020020000010
010010010000020
011222222222020
020200050002020
020201111102020
020201111102220
020201111102020
020200000002020
012211111112020
010020000000020
020020000010010
022221121122220
000000000000000
7 10