000000000000000
022112120011120
010020020010010
020010020010020
022222222222110
000200050002010
000201111102020
022201111102220
020201111102010
010200000002010
010211111112210
010000020000020
020010020010010
011221210012120
000000000000000
7 10