000000000000000
011111111111110
010010000010010
010010000010010
011222222222110
010200050002010
010201111102010
011201111102010
010201111102010
010200000002010
011211111112110
020010010010010
020010010010010
021110011111110
000000000000000
7 10