000000000000000
022222222222220
020000000000020
020000000000020
022222222222220
000200050002000
000201111102000
022201111102220
020201111102020
020200000002020
022222222222220
020020020020020
020020020020020
022222220022220
000000000000000
7 10