000000000000000
011121211211220
020010020000010
010010020000010
020222222222120
010200050002010
010201111102010
010201111102220
010201111102000
020200000002000
020211111112210
020000010000020
010000010000010
022112211121220
000000000000000
7 10