000000000000000
012112112221120
020010020010020
020000010010020
012222222222210
020200050002020
010201111102020
022201111102020
010201111102010
010200000002020
022211111112110
010010010020010
010010010020010
011212211221110
000000000000000
7 10