000000000000000
021210022211110
010020010000010
010020000000010
022222222222120
020200050002010
010201111102020
021201111102120
020201111102010
010200000002020
011211111112120
020000000000010
010010000000020
022112211112120
000000000000000
7 10