000000000000000
022220012211110
010010010020010
020000000020010
022222222222010
000200050002010
000201111102010
021201111102110
020201111102020
010200000002010
022211111112120
020000000020010
010000000020010
011121111212210
000000000000000
7 10