000000000000000
021120012211210
020020010000020
010010000000020
010222222222010
020200050002010
020201111102010
021201111102220
010201111102020
020200000002020
011211111112010
010020010020020
010020020020010
011121110022220
000000000000000
7 10