000000000000000
022112221122110
020020010010020
020020010000020
022222222222110
020200050002020
010201111102010
021201111102220
000201111102010
000200000002020
021211111112110
010010000020010
010020000020020
012122212112120
000000000000000
7 10