000000000000000
022212222222210
010010010000010
010000010000020
021222222222110
020200050002010
020201111102010
011201111102020
020201111102010
020200000002010
020211111112220
010020010000010
010020020000020
012212121222120
000000000000000
7 10