000000000000000
022122211121110
020010000020020
020010000020010
011222222222020
020200050002020
020201111102020
022201111102110
020201111102000
010200000002000
012211111112210
020000000010020
020000000010010
011211111122210
000000000000000
7 10