000000000000000
021212212211120
020010000020010
020010000020020
012222222222220
000200050002010
000201111102010
021201111102110
020201111102010
010200000002010
011211111112120
020000010000010
010010010010010
021122112111120
000000000000000
7 10