000000000000000
011111111111110
010010000000010
010010000000010
011222222222110
010200050002010
010201111102010
010201111102010
010201111102010
010200000002010
011211111112010
010010010010020
010010010010020
011110011112220
000000000000000
7 10