000000000000000
022112221221110
010020000000010
020010000000020
022222222222120
000200050002010
000201111102020
011201111102120
020201111102000
010200000002000
022211111112220
020010010010020
010010020010010
022220022111110
000000000000000
7 10