000000000000000
011210012221210
020010010020010
010000010010010
022222222222010
020200050002010
010201111102010
020201111102010
010201111102010
010200000002010
021211111112020
020000020010020
010010020020020
012112111122210
000000000000000
7 10