000000000000000
012110011122220
020020010010020
020010000010020
022222222222020
000200050002020
000201111102010
011201111102010
020201111102020
010200000002020
011211111112120
020010000000010
020020000010010
021121112221220
000000000000000
7 10