000000000000000
012211112112110
020000010000010
010000010000020
012222222222220
000200050002020
000201111102020
022201111102110
020201111102000
010200000002000
022211111112220
010020020000010
010020020000020
022121221222210
000000000000000
7 10