000000000000000
011110011111110
010010010010010
010010010010010
010222222222110
010200050002000
010201111102000
011201111102110
000201111102010
000200000002010
011211111112110
020010000010010
020010000010010
021111111111110
000000000000000
7 10