000000000000000
021211120012110
020020020010020
010020010010010
011222222222020
000200050002010
000201111102020
010201111102020
020201111102010
010200000002020
011211111112220
020000020000010
020010020000020
011220011222110
000000000000000
7 10