000000000000000
021110021112110
010010020020010
020000020010020
010222222222010
020200050002020
020201111102020
022201111102010
000201111102020
000200000002020
012211111112020
010010000000020
020010010010010
012120011112220
000000000000000
7 10