000000000000000
012220012212120
020010010000020
010010000000010
022222222222210
020200050002010
010201111102020
022201111102020
020201111102010
020200000002020
022211111112120
010000010000020
020010020000020
011220022211110
000000000000000
7 10