000000000000000
021222111221220
010000000000010
010000000000020
021222222222210
010200050002010
020201111102020
011201111102010
000201111102020
000200000002020
021211111112220
020020000020020
020020000020010
012111111222110
000000000000000
7 10