000000000000000
011111210012220
020020020010010
010020020010010
012222222222110
010200050002020
020201111102010
010201111102020
010201111102020
020200000002010
011211111112210
010000010000010
020000020000020
012111121121120
000000000000000
7 10