000000000000000
022222222222220
020020000020020
020020000020020
022222222222220
020200050002000
020201111102000
020201111102220
020201111102020
020200000002020
020211111112220
020000020020020
020000020020020
022222220022220
000000000000000
7 10