000000000000000
011110011111110
010010010010010
010010010010010
010222222222110
010200050002000
010201111102000
011201111102110
010201111102010
010200000002010
011211111112110
020010010010010
020010010010010
021111111111110
000000000000000
7 10