000000000000000
011110011111110
010010010010010
010010010010010
010222222222110
010200050002010
010201111102010
011201111102110
000201111102010
000200000002010
011211111112110
020010010000010
020010010000010
021111111111110
000000000000000
7 10