000000000000000
021110011111110
010010010010010
010010010010010
010222222222110
010200050002000
010201111102000
011201111102110
000201111102010
000200000002010
011211111112110
010010010010010
010010010010010
011111110011110
000000000000000
7 10