000000000000000
012212110012110
010000010010010
010000010000020
011222222222110
020200050002000
020201111102000
010201111102220
010201111102010
020200000002010
022211111112020
020010020020010
020020020020020
012120021222220
000000000000000
7 10