000000000000000
011111211122110
010000000020010
020000000020010
012222222222210
020200050002010
010201111102010
021201111102010
020201111102010
020200000002010
022211111112120
020000000000010
010000010010010
022122110022210
000000000000000
7 10