000000000000000
012120022211120
020010010010010
020010000000020
010222222222210
020200050002010
020201111102010
010201111102020
020201111102020
010200000002020
012211111112010
020000020020020
020000020020020
012212122211210
000000000000000
7 10