000000000000000
021210012222210
010010010020020
020010010020020
012222222222110
000200050002010
000201111102010
010201111102010
020201111102020
010200000002020
021211111112020
010020020010010
010020020010010
012122110021210
000000000000000
7 10