000000000000000
022211221121210
020000010020020
020000000010010
012222222222110
020200050002020
020201111102010
010201111102010
020201111102020
010200000002020
021211111112110
010010010020020
010010020020020
012210012122220
000000000000000
7 10