000000000000000
022111111211110
010000000020020
020000000010010
011222222222120
000200050002010
000201111102010
011201111102110
020201111102010
020200000002010
012211111112120
010000010020010
010010010020010
011222122111220
000000000000000
7 10