000000000000000
022211111122110
010020010010010
020020010010020
011222222222210
010200050002020
020201111102020
011201111102220
010201111102020
010200000002010
012211111112110
020000010020010
010000010020010
011121120012220
000000000000000
7 10