000000000000000
011111111111110
010000010010010
010000010010010
010222222222110
010200050002010
010201111102010
011201111102110
000201111102010
000200000002010
011211111112110
010000000010020
010000000010020
011111111112220
000000000000000
7 10