000000000000000
021110011111110
010010010010010
010010010010010
011222222222110
000200050002010
000201111102010
011201111102110
010201111102010
010200000002010
011211111112010
010010010010010
010010010010010
011111110011110
000000000000000
7 10