000000000000000
011221120021220
010020020020020
010020010010020
011222222222120
000200050002020
000201111102010
011201111102010
020201111102000
020200000002000
020211111112220
020020020020010
020020020020010
021221112221110
000000000000000
7 10