000000000000000
022212121122110
010000020010010
010000010010010
022222222222020
010200050002010
010201111102010
022201111102010
000201111102020
000200000002010
021211111112220
010020010000010
020020020000010
012210012221210
000000000000000
7 10