000000000000000
022211212122220
020010010000020
020010000000020
010222222222210
020200050002020
010201111102020
010201111102110
000201111102000
000200000002000
012211111112220
020010000000010
010020010000020
021221212112110
000000000000000
7 10