000000000000000
011122222222110
010020020020020
020010020020020
021222222222120
000200050002000
000201111102000
010201111102010
020201111102020
010200000002010
022211111112110
020000010020020
010000020020020
012221222211110
000000000000000
7 10