000000000000000
011110011111110
010010010010010
010010010010010
011222222222010
010200050002010
010201111102010
011201111102110
000201111102000
000200000002000
011211111112110
010000010010020
010000010010020
011111110012220
000000000000000
7 10