000000000000000
011221121122120
020000010010010
020000010010020
010222222222010
020200050002010
020201111102020
020201111102220
020201111102010
020200000002020
010211111112020
020010010000010
020010020010010
012120012112220
000000000000000
7 10