000000000000000
011111111111110
010010010010010
010010010010010
011222222222110
010200050002010
010201111102010
010201111102010
010201111102010
010200000002010
010211111112010
010010010010020
010010010010020
011111110012220
000000000000000
7 10