000000000000000
012211212121210
010020000010020
020010000010010
020222222222210
010200050002000
010201111102000
010201111102110
010201111102010
010200000002020
022211111112010
010000010010020
010010010010010
021112212222120
000000000000000
7 10