000000000000000
011120011211210
010020010020010
010020000010020
011222222222210
010200050002010
010201111102020
010201111102010
010201111102020
020200000002020
010211111112010
020010000010010
010020000020010
021222212221220
000000000000000
7 10