000000000000000
011210011122120
010020010010020
010010000010020
011222222222210
010200050002010
020201111102020
021201111102110
020201111102020
020200000002020
020211111112120
020010000000020
020010010000010
022111111212210
000000000000000
7 10