000000000000000
021212212221110
010010000010010
010000000010020
020222222222220
010200050002010
010201111102010
011201111102010
010201111102020
010200000002020
021211111112120
020000000010020
020000010020020
022122121111120
000000000000000
7 10