000000000000000
011111110011110
010010010010010
010010010010010
011222222222110
000200050002000
000201111102000
011201111102110
010201111102010
010200000002010
010211111112110
010010000000020
010010000000020
011111111112220
000000000000000
7 10