000000000000000
012111211112220
010020000020010
010020000020010
011222222222010
000200050002010
000201111102010
010201111102010
020201111102010
020200000002020
011211111112220
010010000000010
010020010000020
021121212211220
000000000000000
7 10