000000000000000
022222222222220
020020000000020
020020000000020
020222222222220
020200050002020
020201111102020
020201111102020
020201111102020
020200000002020
022222222222220
020020000020020
020020000020020
022222222222220
000000000000000
7 10