000000000000000
012120021222120
020010020010010
020010020010010
020222222222010
010200050002020
010201111102020
021201111102020
000201111102010
000200000002020
012211111112020
010010000010010
010010000010020
022221122222210
000000000000000
7 10