000000000000000
012220012222110
020010020000010
020010020000020
011222222222220
010200050002020
020201111102010
011201111102120
000201111102000
000200000002000
012211111112210
020010020000010
010020020000020
022220011212210
000000000000000
7 10