000000000000000
021121120022220
010010010010020
010010010000020
011222222222020
000200050002010
000201111102010
011201111102220
020201111102000
010200000002000
022211111112110
020010000000010
010020000000010
012111212221110
000000000000000
7 10