000000000000000
021210012222210
010020010000020
020020010000010
011222222222220
010200050002000
010201111102000
020201111102010
020201111102010
010200000002010
020211111112210
020010000000020
020020010010020
022210012112110
000000000000000
7 10