000000000000000
022222111122220
010020000000010
020010000000010
020222222222110
020200050002010
020201111102020
010201111102110
020201111102010
020200000002020
010211111112020
020000000000010
020010000000010
022211212121220
000000000000000
7 10