000000000000000
022112222112220
010000010020010
010000010020010
021222222222110
000200050002020
000201111102010
010201111102120
010201111102020
020200000002020
012211111112120
010000000010010
010000010020020
012211121112220
000000000000000
7 10