000000000000000
022110022112210
020020020010010
010010010010010
021222222222120
000200050002020
000201111102020
011201111102010
020201111102010
010200000002010
011211111112020
010010000000020
020020010010010
011220021111110
000000000000000
7 10