000000000000000
012210012112210
010020020000020
020010010000010
020222222222020
010200050002010
010201111102010
010201111102010
010201111102020
010200000002010
020211111112120
020000000010010
010010000020020
021122222221210
000000000000000
7 10