000000000000000
021212221211110
020010020020010
010010020020020
020222222222220
020200050002010
010201111102020
020201111102010
020201111102010
010200000002020
021211111112010
010000010000020
020010010000010
012211212122220
000000000000000
7 10