000000000000000
021211210012110
020000010020020
020000000020010
010222222222210
020200050002020
010201111102020
011201111102220
000201111102000
000200000002000
011211111112210
010010010020010
020020020020010
011122110021210
000000000000000
7 10