000000000000000
021111111111110
010010010000010
010010010000010
011222222222110
010200050002010
010201111102010
011201111102010
000201111102010
000200000002010
011211111112110
010000010000010
010000010000010
011111111111110
000000000000000
7 10