000000000000000
022120011221220
020010020010020
020010010000020
012222222222020
010200050002010
010201111102010
021201111102110
020201111102010
020200000002020
022211111112020
020000020010020
020010020020010
021122220012120
000000000000000
7 10