000000000000000
022211220022210
010020010010020
020020010000020
011222222222210
020200050002020
010201111102010
020201111102020
010201111102010
020200000002010
020211111112120
010010020000010
020010020000010
011210012111120
000000000000000
7 10