000000000000000
012222211211120
020010000010010
020000000010010
012222222222210
000200050002020
000201111102020
010201111102010
020201111102020
020200000002020
022211111112120
010000000010010
020000010010020
012122220021110
000000000000000
7 10