000000000000000
022210011211110
020020010020010
010020010020010
020222222222220
020200050002010
020201111102020
022201111102010
000201111102020
000200000002010
022211111112120
010010020020010
020020020020020
021220011221110
000000000000000
7 10