000000000000000
012222122212120
020020010020020
010020000020010
020222222222020
010200050002010
020201111102020
010201111102010
010201111102010
020200000002010
021211111112210
010000000000010
020010010010010
022110022112120
000000000000000
7 10