000000000000000
022210022121210
020010020020010
010010010020010
012222222222020
000200050002010
000201111102020
021201111102010
020201111102010
020200000002010
022211111112020
010010010000020
010020010010010
021220021112210
000000000000000
7 10