000000000000000
022222222222220
020000000020020
020000000020020
022222222222220
000200050002020
000201111102020
022201111102220
020201111102020
020200000002020
020211111112220
020020020020020
020020020020020
022222220022220
000000000000000
7 10