000000000000000
011120012212110
010020010010010
020020010000020
012222222222110
010200050002000
020201111102000
011201111102010
020201111102020
020200000002020
020211111112020
020010000010010
020010010010020
012122210012210
000000000000000
7 10