000000000000000
022112212121210
020000000020020
020000000010020
010222222222110
010200050002020
010201111102020
010201111102120
000201111102010
000200000002010
021211111112020
010000010010020
020010020010010
011221210022120
000000000000000
7 10