000000000000000
022220022222220
020020020020020
020020020020020
022222222222220
000200050002020
000201111102020
022201111102020
020201111102020
020200000002020
020211111112220
020020020000020
020020020000020
022222222222220
000000000000000
7 10