000000000000000
022120012222210
010010020010020
020010010010020
010222222222120
020200050002010
020201111102010
022201111102120
020201111102000
020200000002000
021211111112120
020020010000010
020020010010020
012212111111120
000000000000000
7 10