000000000000000
011110011111110
010010010010010
010010010010010
010222222222110
010200050002010
010201111102010
010201111102110
010201111102000
010200000002000
010211111112110
020010000000010
020010000000010
021111111111110
000000000000000
7 10