000000000000000
011210011112120
010020010010020
020010010000010
012222222222110
000200050002010
000201111102020
021201111102010
010201111102010
020200000002010
020211111112120
020000000010010
010000000010020
021121112211210
000000000000000
7 10