000000000000000
022112221222220
010000010010010
020000000000020
011222222222210
000200050002020
000201111102010
011201111102120
020201111102020
010200000002020
012211111112020
020000020010020
010010020010020
011222211112120
000000000000000
7 10