000000000000000
022120011121110
010010020010010
020010020000010
011222222222020
000200050002010
000201111102010
022201111102110
020201111102000
010200000002000
021211111112220
020020020010010
010020020020020
012110022222110
000000000000000
7 10