000000000000000
011112122222120
020020000000010
010010000000010
010222222222220
020200050002000
010201111102000
010201111102110
010201111102010
010200000002010
021211111112110
010010000000010
020020000000020
011221222212210
000000000000000
7 10