000000000000000
011111110011110
010010010010010
010010010010010
011222222222110
000200050002000
000201111102000
011201111102110
010201111102010
010200000002010
011211111112010
020010010010010
020010010010010
021110011111110
000000000000000
7 10