000000000000000
022210012221210
010010020010020
010000020000010
011222222222220
010200050002020
010201111102010
021201111102010
000201111102020
000200000002020
022211111112220
020020000020020
020020010020010
011221121111110
000000000000000
7 10