000000000000000
021122112221110
020020010020010
010010000010010
020222222222120
010200050002000
020201111102000
011201111102120
000201111102010
000200000002010
022211111112110
020000010020020
020010020020010
021110012212120
000000000000000
7 10