000000000000000
022222222222220
020020020020020
020020020020020
020222222222220
020200050002000
020201111102000
022201111102220
000201111102020
000200000002020
022211111112220
020000020000020
020000020000020
022222222222220
000000000000000
7 10