000000000000000
011111110011110
010010010010010
010010010010010
010222222222010
010200050002010
010201111102010
010201111102110
010201111102000
010200000002000
011211111112110
020010010000010
020010010000010
021111111111110
000000000000000
7 10