000000000000000
022111110012220
020000020020020
010000010020020
022222222222020
010200050002010
020201111102020
010201111102220
010201111102020
010200000002010
011211111112220
010020010010010
010020010020010
011111220012220
000000000000000
7 10