000000000000000
022121111221120
020010000010020
010010000010020
011222222222210
000200050002010
000201111102010
022201111102220
010201111102020
010200000002010
022211111112020
020020020010020
020020020020010
022210012222210
000000000000000
7 10