000000000000000
021221211111210
010020000020010
010010000020020
010222222222210
020200050002010
010201111102010
022201111102220
000201111102000
000200000002000
012211111112220
020010010010020
010010020020020
012122222121220
000000000000000
7 10