000000000000000
022222112122120
020010000020010
020000000020020
022222222222220
010200050002000
020201111102000
022201111102010
020201111102020
010200000002020
011211111112120
010010020000010
020010020010010
022222222211120
000000000000000
7 10