000000000000000
021110012222210
020020020020010
010020020010010
021222222222210
000200050002020
000201111102020
011201111102110
020201111102010
020200000002010
020211111112110
020010010010020
020020010020010
021221221111220
000000000000000
7 10