000000000000000
022110012111120
020020020010010
020010010000010
012222222222020
020200050002020
020201111102020
021201111102010
020201111102000
010200000002000
012211111112120
010000000010020
010000000010010
011221212111220
000000000000000
7 10