000000000000000
022212222112210
010000020010020
020000020000020
012222222222110
000200050002000
000201111102000
021201111102220
010201111102020
010200000002010
010211111112210
020000010000010
020010020000010
021220012112120
000000000000000
7 10