000000000000000
012222120012110
010010010010010
010010010010010
010222222222110
010200050002000
020201111102000
020201111102220
010201111102020
020200000002010
021211111112210
010000010010010
020010010020010
021212122221220
000000000000000
7 10