000000000000000
021122120011220
020000010010010
010000000010020
021222222222010
000200050002010
000201111102020
022201111102110
020201111102010
020200000002020
012211111112210
010010010020020
010020020020020
022220022221210
000000000000000
7 10