000000000000000
011111111111110
010010010010010
010010010010010
011222222222110
000200050002010
000201111102010
011201111102110
010201111102010
010200000002010
011211111112110
010000010010020
010000010010020
011111111112220
000000000000000
7 10