000000000000000
021112120022210
010020010020020
010010000010020
021222222222220
020200050002020
020201111102020
020201111102220
010201111102000
020200000002000
012211111112220
010010000010020
010010010020020
012222110012220
000000000000000
7 10