000000000000000
012222212222110
020020000010010
010020000000020
021222222222210
020200050002020
010201111102020
010201111102220
010201111102020
020200000002020
022211111112120
010010000000020
020010000000020
021211121112120
000000000000000
7 10