000000000000000
011111110011110
010010010010010
010010010010010
011222222222110
000200050002010
000201111102010
011201111102110
010201111102000
010200000002000
010211111112110
020010000000010
020010000000010
021111111111110
000000000000000
7 10