000000000000000
011111111111110
010000010010010
010000010010010
010222222222110
010200050002010
010201111102010
011201111102110
010201111102000
010200000002000
011211111112110
020010000010010
020010000010010
021111111111110
000000000000000
7 10