000000000000000
011112222121110
020000010010020
020000010000020
021222222222110
000200050002010
000201111102010
011201111102010
010201111102010
010200000002020
010211111112120
020000000000010
010010010000020
011122112222120
000000000000000
7 10