000000000000000
022222220022220
020020020020020
020020020020020
020222222222020
020200050002020
020201111102020
022201111102220
000201111102000
000200000002000
022211111112220
020020020020020
020020020020020
022222222222220
000000000000000
7 10