000000000000000
012212222222220
020010020010010
010000020010010
020222222222210
010200050002020
010201111102010
010201111102220
020201111102000
010200000002000
022211111112220
020000000020020
010000000020020
011212112122220
000000000000000
7 10