000000000000000
022210012122110
020010020010010
020000020000020
020222222222020
010200050002010
010201111102020
010201111102010
010201111102020
020200000002010
020211111112110
020000000020010
010010010020020
012221220012220
000000000000000
7 10