000000000000000
021120012122210
010010020010020
010000010000010
021222222222220
000200050002020
000201111102020
021201111102010
020201111102010
020200000002020
011211111112210
010010010010010
020020020020010
011111110021110
000000000000000
7 10