000000000000000
021111121211220
010020010010020
020020000000010
020222222222220
020200050002000
010201111102000
022201111102220
010201111102020
020200000002010
020211111112220
010010000010020
010020000010020
011211211111110
000000000000000
7 10