000000000000000
011220022122220
010010010020010
010010000010020
022222222222010
010200050002010
010201111102020
022201111102010
000201111102010
000200000002020
011211111112010
020020010000020
010020020010010
022111112211220
000000000000000
7 10