000000000000000
021110011111110
010010010000010
010010010000010
011222222222010
010200050002010
010201111102010
010201111102110
010201111102010
010200000002010
011211111112010
010010000010010
010010000010010
011111111111110
000000000000000
7 10