000000000000000
021111220012110
020020010010010
020020010010020
012222222222120
020200050002010
020201111102020
022201111102220
010201111102020
020200000002010
011211111112210
020000010010010
010010010020010
022220011211120
000000000000000
7 10