000000000000000
021220022111220
020020010010020
010010010000020
011222222222210
020200050002020
010201111102020
022201111102010
000201111102000
000200000002000
012211111112220
020010010010020
010020020020020
022111111212210
000000000000000
7 10