000000000000000
022220012211220
020010020020020
010010010010010
010222222222010
020200050002020
020201111102020
010201111102110
020201111102010
010200000002010
010211111112210
010010010010010
010020020020010
022111110012220
000000000000000
7 10