000000000000000
022211112212120
020020000020020
010020000020020
012222222222220
010200050002020
020201111102010
011201111102120
020201111102000
020200000002000
010211111112120
020000000000010
010000000000010
011212211122210
000000000000000
7 10