000000000000000
022212222122210
020020000020020
010010000010020
022222222222210
020200050002010
020201111102020
011201111102220
010201111102020
010200000002010
011211111112110
020010010010010
020020020020020
012211110021110
000000000000000
7 10