000000000000000
012112211211110
010000010010010
020000000010010
011222222222010
000200050002010
000201111102010
011201111102010
020201111102000
020200000002000
010211111112220
010010000000010
010010000000010
021121112112210
000000000000000
7 10