000000000000000
012111222112120
010010020020020
010000010010010
022222222222010
000200050002010
000201111102010
021201111102220
020201111102010
010200000002010
011211111112110
010010000000020
020010000000010
011112212111220
000000000000000
7 10