000000000000000
021111111111110
010000010010010
010000010010010
011222222222110
000200050002010
000201111102010
011201111102110
010201111102000
010200000002000
011211111112110
010000010000010
010000010000010
011111111111110
000000000000000
7 10