000000000000000
011122121111220
010000000000010
010000000000020
021222222222110
000200050002020
000201111102010
010201111102220
010201111102020
020200000002020
020211111112010
020020010010020
020020020010020
021121110012220
000000000000000
7 10