000000000000000
012112212212220
020010010000010
010000010000020
011222222222220
020200050002020
020201111102010
010201111102010
000201111102020
000200000002010
022211111112220
020000000020020
010000010020010
011112222222220
000000000000000
7 10