000000000000000
022212111122110
010000010020020
010000010010010
021222222222020
020200050002020
010201111102010
020201111102010
010201111102010
020200000002010
022211111112110
010000000010020
010000000010020
022221121111210
000000000000000
7 10