000000000000000
011122120012120
020020010010010
010020000000020
011222222222020
000200050002010
000201111102010
022201111102220
010201111102000
010200000002000
010211111112220
020020020010020
010020020010010
012212211122120
000000000000000
7 10