000000000000000
012122112121220
020000000010020
020000000000020
012222222222110
000200050002010
000201111102010
010201111102010
020201111102010
020200000002010
011211111112020
010000000000010
020010000010020
022111122212210
000000000000000
7 10