000000000000000
011222212111210
020020020000020
010010010000020
021222222222020
010200050002010
020201111102010
010201111102010
020201111102010
020200000002020
012211111112010
010020020010020
020020020020010
021220021211110
000000000000000
7 10