000000000000000
022110022111110
020010010020010
020010010020020
010222222222020
020200050002010
020201111102020
010201111102020
010201111102010
020200000002010
021211111112220
010000010020020
010000010020020
011122222122210
000000000000000
7 10