000000000000000
011111111111110
010010000000010
010010000000010
011222222222110
010200050002010
010201111102010
011201111102010
000201111102010
000200000002010
011211111112110
020000010000010
020000010000010
021111111111110
000000000000000
7 10