000000000000000
012221110022110
010010010020010
010000010020020
022222222222220
020200050002010
010201111102020
011201111102020
020201111102020
010200000002020
012211111112210
010000010010010
010010020010010
012110022222120
000000000000000
7 10