000000000000000
011111122111210
020020000000020
010010000000020
011222222222120
010200050002000
010201111102000
020201111102110
020201111102020
010200000002020
022211111112210
010020000000010
020020010000010
022220011121120
000000000000000
7 10