000000000000000
012212122221110
010000020000010
010000010000020
021222222222110
000200050002010
000201111102020
021201111102010
020201111102010
020200000002020
012211111112220
020000000010010
010010000020010
022111111212210
000000000000000
7 10