000000000000000
011111110011110
010010010010010
010010010010010
011222222222110
010200050002010
010201111102010
011201111102010
000201111102010
000200000002010
011211111112110
020010010000010
020010010000010
021110011111110
000000000000000
7 10