000000000000000
011111110011110
010010010010010
010010010010010
011222222222110
010200050002010
010201111102010
011201111102110
010201111102010
010200000002010
010211111112110
020010010010010
020010010010010
021110011111110
000000000000000
7 10