000000000000000
012111111221220
010010000000020
010010000000020
011222222222210
000200050002010
000201111102010
022201111102120
010201111102010
010200000002020
021211111112210
020010000000010
020020000000020
022111121112110
000000000000000
7 10