000000000000000
022122211112220
010010000010010
020000000000010
011222222222010
000200050002020
000201111102010
010201111102010
010201111102020
010200000002020
012211111112020
020020020010020
010020020020010
021110021221110
000000000000000
7 10