000000000000000
011112111112210
010020010020020
020020010010020
021222222222210
010200050002020
020201111102010
022201111102010
000201111102020
000200000002010
021211111112020
020020000000020
010020000000020
022121121112110
000000000000000
7 10