000000000000000
021210021112210
010020020000020
010010020000010
020222222222020
020200050002010
020201111102020
021201111102010
020201111102000
010200000002000
010211111112220
010010000010020
010020000010010
011111222221110
000000000000000
7 10