000000000000000
012112212212220
010000000020010
020000000020020
011222222222210
020200050002020
010201111102010
020201111102120
010201111102000
010200000002000
022211111112220
010000010010010
020010010020020
012220021112210
000000000000000
7 10