000000000000000
012122120011120
010020010010010
020020010000010
011222222222020
020200050002020
020201111102010
022201111102010
010201111102010
010200000002010
010211111112110
020020000000020
020020000000010
022212211221120
000000000000000
7 10