000000000000000
011221120011120
010020020020010
020010010010020
020222222222220
010200050002000
010201111102000
010201111102220
000201111102020
000200000002020
022211111112220
020020010000020
010020020000020
012220012121210
000000000000000
7 10