000000000000000
011111111112220
010000010000010
010000010000010
011222222222110
000200050002010
000201111102010
011201111102110
010201111102010
010200000002010
011211111112110
010010010010010
010010010010010
011110011111110
000000000000000
7 10